Srl,Txn  Date,Value  Date,Description,CR/DR,CCY,Amount  (INR),Balance  (INR)
1,01-09-2023,01-09-2023,IPS/LIFE  LINE  M/202309011903/000000001609/PUNE,Dr.,INR,349,817112
2,05-09-2023,05-09-2023,BIL/NEFT/HS92324815226423/College  Fees/MANAS/SBIN0,Dr.,INR,450000,367112
3,05-09-2023,05-09-2023,BIL/BPAY/0000000LDFHM/BBPS/Vi  Postpai/727609,Dr.,INR,574,366538
4,07-09-2023,07-09-2023,ACH/LIC  OF  INDIA/9595696740923,Dr.,INR,1531,365007
5,08-09-2023,08-09-2023,VPS/HP  AUTO  CAR/202309081805/325112722015/NASIK,Dr.,INR,1964,363042
6,10-09-2023,11-09-2023,VPS/SHREE  SWAMI/202309110133/325320043535/Pune,Dr.,INR,590,362452
7,11-09-2023,11-09-2023,ACH/NJINDIAINVESTPVT/40551324,Dr.,INR,2000,360452
8,11-09-2023,11-09-2023,ACH/NJINDIAINVESTPVT/40551325,Dr.,INR,2000,358452
9,11-09-2023,11-09-2023,ACH/NJINDIAINVESTPVT/40551326,Dr.,INR,2000,356452
10,11-09-2023,11-09-2023,ACH/NJINDIAINVESTPVT/40551327,Dr.,INR,2000,354452
11,11-09-2023,11-09-2023,ACH/NJINDIAINVESTPVT/40551328,Dr.,INR,2000,352452
12,11-09-2023,11-09-2023,BIL/ONL/000722857447/Maha  Elect/MSEBMUM_YICI207,Dr.,INR,910,351542
13,11-09-2023,11-09-2023,To  RD  Ac  no  000525071243,Dr.,INR,50000,301542
14,14-09-2023,14-09-2023,BIL/NEFT/HS92325716303335/Family/PRAMOD  PRA/SBIN00,Dr.,INR,1000,300542
15,17-09-2023,18-09-2023,BIL/NEFT/HS92326016547193/PRAMOD/SBIN0000575,Dr.,INR,5000,295542
16,20-09-2023,20-09-2023,BIL/BPAY/0000000LTPWD/BBPS/Vi  Postpai/955258,Dr.,INR,941,294600
17,21-09-2023,21-09-2023,CMS/001282872701/KOTAKMFV_168__4554835,Dr.,INR,2000,292600
18,21-09-2023,21-09-2023,VPS/HP  AUTO  CAR/202309211803/326412849960/NASIK,Dr.,INR,2094,290506
19,23-09-2023,23-09-2023,BIL/ONL/000727783501/ZERODHA/938551143288773,Dr.,INR,2000,288506
20,23-09-2023,23-09-2023,BIL/ONL/000727793706/BSE  LIMITE/MFNFNDM5IOVPHP/Sip,Dr.,INR,500,288006
21,27-09-2023,27-09-2023,BIL/BPAY/0000000LZYZ1/BBPS/Vi  Postpai/727609,Dr.,INR,398,287608
22,28-09-2023,28-09-2023,VPS/HP  AUTO  CAR/202309281806/327112582977/NASIK,Dr.,INR,2137,285470
23,29-09-2023,29-09-2023,NEFT-N272232660762199-TATA  MOTORS  LIMITED-TML  SALARY/PEN/OTH-00070310001852-HDF,Cr.,INR,155525,440995
24,29-09-2023,29-09-2023,BIL/NEFT/HS92327217520446/PRAMOD/SBIN0000575,Dr.,INR,6000,434995
25,29-09-2023,29-09-2023,BIL/NEFT/HS92327217521023/MANAS/SBIN0016846,Dr.,INR,2000,432995
26,29-09-2023,29-09-2023,BIL/NEFT/HS92327217518634/RUPALI  MUL/SBIN0016846,Dr.,INR,40000,392995
27,29-09-2023,30-09-2023,000501534170:Int.Pd:30-06-2023  to  29-09-2023,Cr.,INR,4650,397645
28,02-10-2023,02-10-2023,BIL/ONL/000732169931/NPS  Trust/XBCMFNPSK_ZICI1,Dr.,INR,50000,347645
29,07-10-2023,07-10-2023,ACH/LIC  OF  INDIA/ICIC0000000013232747/959569674102,Dr.,INR,1531,346114
30,07-10-2023,07-10-2023,VPS/ABHINANDAN  /202310072133/328016002715/PUNE,Dr.,INR,350,345764
31,08-10-2023,09-10-2023,VPS/GLOBE  WINES/202310081814/328112454101/PUNE,Dr.,INR,230,345534
32,08-10-2023,09-10-2023,VPS/HP  AUTO  CAR/202310081823/328112464177/NASIK,Dr.,INR,2258,343276
33,09-10-2023,09-10-2023,BIL/ONL/000736173701/Maha  Elect/MSEBMUM_YICI210,Dr.,INR,940,342336
34,10-10-2023,10-10-2023,ACH/NJINDIAINVESTPVT/ICIC6000000005555523/40551326,Dr.,INR,2000,340336
35,10-10-2023,10-10-2023,ACH/NJINDIAINVESTPVT/ICIC6000000005555523/40551324,Dr.,INR,2000,338336
36,10-10-2023,10-10-2023,ACH/NJINDIAINVESTPVT/ICIC6000000005555523/40551325,Dr.,INR,2000,336336
37,10-10-2023,10-10-2023,ACH/NJINDIAINVESTPVT/ICIC6000000005555523/40551328,Dr.,INR,2000,334336
38,10-10-2023,10-10-2023,ACH/NJINDIAINVESTPVT/ICIC6000000005555523/40551327,Dr.,INR,2000,332336
39,10-10-2023,10-10-2023,To  RD  Ac  no  000525071243,Dr.,INR,50000,282336
40,12-10-2023,12-10-2023,BIL/NEFT/HS92328519433972/Rent/ASA              /SBIN0007,Dr.,INR,5000,277336
41,12-10-2023,12-10-2023,BIL/NEFT/HS92328519442058/Own/ASA              /SBIN00073,Dr.,INR,5000,272336
42,21-10-2023,21-10-2023,BIL/NEFT/HS92329420220710/PRAMOD/SBIN0000575,Dr.,INR,4000,268336
43,21-10-2023,21-10-2023,CMS/001303400981/KOTAKMFV_168__4554835,Dr.,INR,2000,266336
44,21-10-2023,21-10-2023,BIL/BPAY/0000000MQJ8J/BBPS/Vi  Postpai/955258,Dr.,INR,941,265394
45,21-10-2023,21-10-2023,VPS/HINDUSTAN  P/202310212038/329415091728/NASIK,Dr.,INR,2132,263262
46,26-10-2023,26-10-2023,NEFT-YESB32990359597-ZERODHA  BROKING  LTD-DSCNB  A/C-YESB0000001-002283000000071-,Cr.,INR,1989,265251
47,27-10-2023,27-10-2023,VPS/PANCHJANYA  /202310271459/330009279899/PUNE,Dr.,INR,1682,263569
48,27-10-2023,27-10-2023,BIL/NEFT/HS92330020694573/Family/PRAMOD        /SBIN00,Dr.,INR,2000,261569
49,28-10-2023,28-10-2023,BIL/NEFT/HS92330120731773/Family/PRAMOD        /SBIN00,Dr.,INR,1000,260569
50,28-10-2023,28-10-2023,VPS/GLOBE  WINES/202310281808/330112884137/PUNE,Dr.,INR,690,259879
51,29-10-2023,30-10-2023,VPS/BATA  INDIA  /202310291218/330206234673/PUNE,Dr.,INR,1799,258080
52,29-10-2023,30-10-2023,VPS/HINDUSTAN  P/202310292035/330215644974/NASIK,Dr.,INR,1433,256646
53,29-10-2023,30-10-2023,ATM/SACWK850/CASH  WDL/29-10-23,Dr.,INR,5000,251646
54,30-10-2023,30-10-2023,VPS/SHREE  GURUD/202310300755/330302744163/KHALAPUR,Dr.,INR,40,251606
55,30-10-2023,30-10-2023,NEFT-N303232708601176-TATA  MOTORS  LIMITED-TML  SALARY/PEN/OTH-00070310001852-HDF,Cr.,INR,156123,407729
56,31-10-2023,31-10-2023,BIL/NEFT/HS92330421018243/MANAS/SBIN0016846,Dr.,INR,2000,405729
57,31-10-2023,31-10-2023,BIL/NEFT/HS92330421019750/PRAMOD/SBIN0000575,Dr.,INR,17000,388729
58,31-10-2023,31-10-2023,BIL/NEFT/HS92330421020038/RUPALI  MUL/SBIN0016846,Dr.,INR,65000,323729
59,31-10-2023,31-10-2023,BIL/BPAY/0000000N0FV7/BBPS/Vi  Postpai/727609,Dr.,INR,352,323376
60,01-11-2023,01-11-2023,BIL/ONL/000746688862/Maharashtr/MNGL_ZICI150218,Dr.,INR,923,322453
61,02-11-2023,02-11-2023,VPS/HP  AUTO  CAR/202311021840/330613724844/NASIK,Dr.,INR,2203,320250
62,05-11-2023,06-11-2023,BIL/NEFT/HS92330922052754/Family/RUPALI  MUL/SBIN00,Dr.,INR,20000,300250
63,05-11-2023,06-11-2023,BIL/NEFT/HS92330922051716/Family/RUPALI  MUL/SBIN00,Dr.,INR,20000,280250
64,06-11-2023,06-11-2023,BIL/NEFT/HS92331022118704/Family/RUPALI  MUL/SBIN00,Dr.,INR,2000,278250
65,06-11-2023,06-11-2023,NEFT-ICMS231106000NOT-LIC  OF  INDIA  DO  1  PUNE      PH    AC  7-LIC  INDIA  D095  -0007102,Cr.,INR,247505,525755
66,09-11-2023,09-11-2023,VPS/HINDUSTAN  P/202311091808/331312977292/NASIK,Dr.,INR,1518,524236
67,10-11-2023,10-11-2023,ACH/NJINDIAINVESTPVT/ICIC6000000005555523/40551324,Dr.,INR,2000,522236
68,10-11-2023,10-11-2023,ACH/NJINDIAINVESTPVT/ICIC6000000005555523/40551325,Dr.,INR,2000,520236
69,10-11-2023,10-11-2023,ACH/NJINDIAINVESTPVT/ICIC6000000005555523/40551326,Dr.,INR,2000,518236
70,10-11-2023,10-11-2023,ACH/NJINDIAINVESTPVT/ICIC6000000005555523/40551327,Dr.,INR,2000,516236
71,10-11-2023,10-11-2023,ACH/NJINDIAINVESTPVT/ICIC6000000005555523/40551328,Dr.,INR,2000,514236
72,10-11-2023,10-11-2023,BIL/ONL/000751862683/Maha  Elect/MSEBMUM_YICI213/El,Dr.,INR,1090,513146
73,10-11-2023,10-11-2023,To  RD  Ac  no  000525071243,Dr.,INR,50000,463146
74,12-11-2023,13-11-2023,ATM/SACWK850/CASH  WDL/12-11-23,Dr.,INR,20000,443146
75,13-11-2023,13-11-2023,BIL/NEFT/HS92331722954303/Bill  Payment/RUPALI  MUL/,Dr.,INR,885,442261
76,14-11-2023,14-11-2023,IPS/DISHA  PETRO/202311141559/000000001370/KOL-KOLH,Dr.,INR,1623,440638
77,14-11-2023,14-11-2023,VPS/MSW  NAMIT  F/202311150139/331820114021/Sangli,Dr.,INR,767,439871
78,15-11-2023,15-11-2023,IPS/AUTOMOTIVE  /202311151924/000000027282/SAN-SANG,Dr.,INR,949,438922
79,20-11-2023,20-11-2023,VPS/AMANTRAN  PU/202311202002/332414200627/PUNE,Dr.,INR,675,438247
80,21-11-2023,21-11-2023,CMS/001322867380/KOTAKMFV_168__4554835,Dr.,INR,2000,436247
81,21-11-2023,21-11-2023,VPS/HP  AUTO  CAR/202311211820/332512743148/NASIK,Dr.,INR,2354,433892
82,22-11-2023,22-11-2023,BIL/BPAY/0000000NO84X/BBPS/Vi  Postpai/955258,Dr.,INR,941,432951
83,23-11-2023,23-11-2023,BIL/NEFT/HS92332723718951/RUPALI  MUL/SBIN0016846,Dr.,INR,30000,402951
84,28-11-2023,28-11-2023,BIL/NEFT/HS92333224091393/Family/PRAMOD        /SBIN00,Dr.,INR,4000,398951
85,28-11-2023,28-11-2023,NEFT-N332232754576891-TATA  MOTORS  LIMITED-TML  SALARY/PEN/OTH-00070310001852-HDF,Cr.,INR,154646,553597
86,28-11-2023,28-11-2023,BIL/NEFT/HS92333224108928/RUPALI  MUL/SBIN0016846,Dr.,INR,40000,513597
87,28-11-2023,28-11-2023,BIL/NEFT/HS92333224109010/PRAMOD/SBIN0000575,Dr.,INR,6000,507597
88,28-11-2023,28-11-2023,BIL/NEFT/HS92333224108264/MANAS/SBIN0016846,Dr.,INR,2000,505597
89,28-11-2023,28-11-2023,BIL/BPAY/0000000NTFKZ/BBPS/Vi  Postpai/727609,Dr.,INR,494,505103
90,01-12-2023,01-12-2023,BIL/NEFT/HS92333524702886/Family/RUPALI  MUL/SBIN00,Dr.,INR,2000,503103
91,03-12-2023,04-12-2023,BIL/ONL/000762249352/Maharashtr/MNGL_ZICI157818/mn,Dr.,INR,821,502282
92,03-12-2023,04-12-2023,VPS/HP  AUTO  CAR/202312031838/333713056939/NASIK,Dr.,INR,2369,499912
93,08-12-2023,08-12-2023,BIL/NEFT/HS92334225798031/Family/RUPALI  MUL/SBIN00,Dr.,INR,2000,497912
94,11-12-2023,11-12-2023,ACH/NJINDIAINVESTPVT/ICIC60000,Dr.,INR,2000,495912
95,11-12-2023,11-12-2023,ACH/NJINDIAINVESTPVT/ICIC6000000005555523/40551324,Dr.,INR,2000,493912
96,11-12-2023,11-12-2023,ACH/NJINDIAINVESTPVT/ICIC6000000005555523/40551327,Dr.,INR,2000,491912
97,11-12-2023,11-12-2023,ACH/NJINDIAINVESTPVT/ICIC6000000005555523/40551326,Dr.,INR,2000,489912
98,11-12-2023,11-12-2023,ACH/NJINDIAINVESTPVT/ICIC6000000005555523/40551328,Dr.,INR,2000,487912
99,11-12-2023,11-12-2023,BIL/ONL/000766490085/Maha  Elect/MSEBMUM_YICI217/el,Dr.,INR,1210,486702
100,11-12-2023,11-12-2023,To  RD  Ac  no  000525071243,Dr.,INR,50000,436702
101,13-12-2023,13-12-2023,VPS/HINDUSTAN  P/202312131804/334712773972/NASIK,Dr.,INR,2117,434584
102,17-12-2023,18-12-2023,ATM/SACWK850/CASH  WDL/17-12-23,Dr.,INR,10000,424584
103,20-12-2023,20-12-2023,BIL/BPAY/0000000OHWEE/BBPS/Vi  Postpai/955258,Dr.,INR,941,423643
104,21-12-2023,21-12-2023,CMS/001343190369/KOTAKMFV_168__4554835,Dr.,INR,2000,421643
105,22-12-2023,22-12-2023,BIL/NEFT/HS92335627033342/Family/MANAS          /SBIN00,Dr.,INR,1500,420143
106,22-12-2023,22-12-2023,BIL/NEFT/HS92335627033498/Family/PRAMOD  PRA/SBIN00,Dr.,INR,2000,418143
107,27-12-2023,27-12-2023,BIL/NEFT/HS92336127451482/Family/RUPALI  MUL/SBIN00,Dr.,INR,2400,415743
108,28-12-2023,28-12-2023,BIL/NEFT/HS92336227569822/Family/MANAS          /SBIN00,Dr.,INR,2500,413243
109,29-12-2023,29-12-2023,NEFT-N363232804769657-TATA  MOTORS  LIMITED-TML  SALARY/PEN/OTH-00070310001852-HDF,Cr.,INR,153407,566650
110,29-12-2023,30-12-2023,000501534170:Int.Pd:30-09-2023  to  29-12-2023,Cr.,INR,2945,569595
111,30-12-2023,30-12-2023,BIL/NEFT/HS92336427755553/MANAS/SBIN0016846,Dr.,INR,2000,567595
112,30-12-2023,30-12-2023,BIL/NEFT/HS92336427755619/PRAMOD/SBIN0000575,Dr.,INR,6000,561595
113,30-12-2023,30-12-2023,BIL/NEFT/HS92336427753610/RUPALI  MUL/SBIN0016846,Dr.,INR,40000,521595
114,30-12-2023,30-12-2023,BIL/BPAY/0000000ORZMS/BBPS/Vi  Postpai/727609,Dr.,INR,400,521194
115,30-12-2023,30-12-2023,TRF  TO  FD  no.  000513261166,Dr.,INR,350000,171194
116,31-12-2023,01-01-2024,VPS/HINDUSTAN  P/202312311917/336513519101/NASIK,Dr.,INR,2537,168657
117,09-01-2024,09-01-2024,BIL/ONL/000780235319/Maha  Elect/MSEBMUM_YICI219,Dr.,INR,980,167677
118,10-01-2024,10-01-2024,ACH/NJINDIAINVESTPVT/ICIC6000000005555523/40551324,Dr.,INR,2000,165677
119,10-01-2024,10-01-2024,ACH/NJINDIAINVESTPVT/ICIC6000000005555523/40551325,Dr.,INR,2000,163677
120,10-01-2024,10-01-2024,ACH/NJINDIAINVESTPVT/ICIC6000000005555523/40551328,Dr.,INR,2000,161677
121,10-01-2024,10-01-2024,ACH/NJINDIAINVESTPVT/ICIC6000000005555523/40551326,Dr.,INR,2000,159677
122,10-01-2024,10-01-2024,ACH/NJINDIAINVESTPVT/ICIC6000000005555523/40551327,Dr.,INR,2000,157677
123,10-01-2024,10-01-2024,To  RD  Ac  no  000525071243,Dr.,INR,50000,107677
124,12-01-2024,12-01-2024,BIL/NEFT/HS92401229743448/NA/ASA              /SBIN000733,Dr.,INR,5000,102677
125,19-01-2024,19-01-2024,BIL/NEFT/HS92401930260871/Family/RUPALI  MUL/SBIN00,Dr.,INR,4000,98677
126,19-01-2024,19-01-2024,VPS/HP  AUTO  CAR/202401191811/401912044072/NASIK,Dr.,INR,2578,96099
127,22-01-2024,22-01-2024,CMS/001364476684/KOTAKMFV_168__4554835,Dr.,INR,2000,94099
128,24-01-2024,24-01-2024,BIL/BPAY/0000000PHC8T/BBPS/Vi  Postpai/955258,Dr.,INR,941,93157
129,29-01-2024,29-01-2024,NEFT-N029242851879586-TATA  MOTORS  LIMITED-TML  SALARY/PEN/OTH-00070310001852-HDF,Cr.,INR,148562,241719
130,29-01-2024,29-01-2024,BIL/NEFT/HS92402931018278/RUPALI  MUL/SBIN0016846,Dr.,INR,46000,195719
131,29-01-2024,29-01-2024,BIL/NEFT/HS92402931018383/PRAMOD/SBIN0000575,Dr.,INR,6000,189719
132,29-01-2024,29-01-2024,BIL/NEFT/HS92402931019698/MANAS/SBIN0016846,Dr.,INR,2000,187719
133,30-01-2024,30-01-2024,BIL/ONL/000788770956/ZERODHA/350301670757065,Dr.,INR,5000,182719
134,30-01-2024,30-01-2024,BIL/NEFT/HS92403031185663/Family/MANASI  MUL/SBIN00,Dr.,INR,3500,179219
135,06-02-2024,06-02-2024,VPS/HP  AUTO  CAR/202402061804/403712139982/NASIK,Dr.,INR,2336,176882
136,08-02-2024,08-02-2024,BIL/NEFT/HS92403932692359/RUPALI  MUL/SBIN0016846,Dr.,INR,6000,170882
137,08-02-2024,08-02-2024,BIL/BPAY/0000000PVGJE/BBPS/Maharashtr/500411,Dr.,INR,975,169907
138,11-02-2024,12-02-2024,BIL/ONL/000795749641/Maha  Elect/MSEBMUM_YICI223,Dr.,INR,1080,168827
139,12-02-2024,12-02-2024,ACH/NJINDIAINVESTPVT/ICIC6000000005555523/40551324,Dr.,INR,2000,166827
140,12-02-2024,12-02-2024,ACH/NJINDIAINVESTPVT/ICIC6000000005555523/40551327,Dr.,INR,2000,164827
141,12-02-2024,12-02-2024,ACH/NJINDIAINVESTPVT/ICIC6000000005555523/40551325,Dr.,INR,2000,162827
142,12-02-2024,12-02-2024,ACH/NJINDIAINVESTPVT/ICIC6000000005555523/40551326,Dr.,INR,2000,160827
143,12-02-2024,12-02-2024,ACH/NJINDIAINVESTPVT/ICIC6000000005555523/40551328,Dr.,INR,2000,158827
144,12-02-2024,12-02-2024,To  RD  Ac  no  000525071243,Dr.,INR,50000,108827
145,13-02-2024,13-02-2024,BIL/ONL/000796577750/ZERODHA/739253385849269,Dr.,INR,5000,103827
146,17-02-2024,17-02-2024,VPS/HINDUSTAN  P/202402171225/404806744187/NASIK,Dr.,INR,2281,101546
147,20-02-2024,20-02-2024,VPS/INFINITI  RE/202402210205/405120311991/PUNE,Dr.,INR,12445,89100
148,20-02-2024,20-02-2024,IPS/GHARONDA  VE/202402202253/022024020522/PIMPRI,Dr.,INR,1417,87683
149,21-02-2024,21-02-2024,CMS/001385704502/KOTAKMFV_168__4554835,Dr.,INR,2000,85683
150,22-02-2024,22-02-2024,BIL/BPAY/0000000Q97SV/BBPS/Vi  Postpai/955258,Dr.,INR,941,84741
151,26-02-2024,26-02-2024,BIL/BPAY/0000000QCNK3/BBPS/Vi  Postpai/727609,Dr.,INR,473,84268
152,26-02-2024,26-02-2024,BIL/NEFT/HS92405734279777/RUPALI  MUL/SBIN0016846,Dr.,INR,2000,82268
153,26-02-2024,26-02-2024,IPS/COCO  HP  AUT/202402261902/022624070595/PIMPRI,Dr.,INR,1930,80337
154,26-02-2024,26-02-2024,ATM/SACWK849/CASH  WDL/26-02-24,Dr.,INR,2500,77837
155,28-02-2024,28-02-2024,NEFT-N059242904237807-TATA  MOTORS  LIMITED-TML  SALARY/PEN/OTH-00070310001852-HDF,Cr.,INR,149313,227150
156,28-02-2024,28-02-2024,BIL/NEFT/HS92405934467420/RUPALI  MUL/SBIN0016846,Dr.,INR,46000,181150
157,28-02-2024,28-02-2024,BIL/NEFT/HS92405934465829/MANAS/SBIN0016846,Dr.,INR,2000,179150
158,28-02-2024,28-02-2024,BIL/NEFT/HS92405934465929/PRAMOD/SBIN0000575,Dr.,INR,6000,173150
159,03-03-2024,04-03-2024,IPS/COCO  HP  AUT/202403031748/030324021955/PIMPRI,Dr.,INR,1599,171551
160,05-03-2024,05-03-2024,CMS/Mrs  Bectors  Food/Dividend  2023-2024,Cr.,INR,1,171552
161,08-03-2024,08-03-2024,IPS/RASARANG  SW/202403081807/030824009447/PIMPRI,Dr.,INR,200,171352
162,08-03-2024,08-03-2024,IPS/COCO  HP  AUT/202403081816/030824107409/PIMPRI,Dr.,INR,1203,170148
163,11-03-2024,11-03-2024,ACH/NJINDIAINVESTPVT/ICIC6000000005555523/40551324,Dr.,INR,2000,168148
164,11-03-2024,11-03-2024,ACH/NJINDIAINVESTPVT/ICIC6000000005555523/40551325,Dr.,INR,2000,166148
165,11-03-2024,11-03-2024,ACH/NJINDIAINVESTPVT/ICIC6000000005555523/40551326,Dr.,INR,2000,164148
166,11-03-2024,11-03-2024,ACH/NJINDIAINVESTPVT/ICIC6000000005555523/40551327,Dr.,INR,2000,162148
167,11-03-2024,11-03-2024,ACH/NJINDIAINVESTPVT/ICIC6000000005555523/40551328,Dr.,INR,2000,160148
168,11-03-2024,11-03-2024,BIL/ONL/000810063854/Maha  Elect/MSEBMUM_YICI226,Dr.,INR,780,159368
169,11-03-2024,11-03-2024,To  RD  Ac  no  000525071243,Dr.,INR,50000,109368
170,14-03-2024,14-03-2024,VPS/HINDUSTAN  P/202403141825/407412343441/NASIK,Dr.,INR,2216,107152
171,20-03-2024,20-03-2024,BIL/BPAY/0000000R0XHI/BBPS/Vi  Postpai/955258,Dr.,INR,941,106211
172,20-03-2024,20-03-2024,BIL/NEFT/HS92408037209635/Friends/ASA              /SBIN0,Dr.,INR,5000,101211
173,20-03-2024,20-03-2024,BIL/NEFT/HS92408037214629/PRAMOD/SBIN0000575,Dr.,INR,25000,76211
174,21-03-2024,21-03-2024,CMS/001408244046/KOTAKMFV_168__4554835,Dr.,INR,2000,74211
175,21-03-2024,21-03-2024,000513261166:  Closure  Proceeds,Cr.,INR,353145,427356
176,21-03-2024,21-03-2024,BIL/NEFT/HS92408137364057/PRAMOD/SBIN0000575,Dr.,INR,175000,252356
177,26-03-2024,26-03-2024,BIL/ONL/000816277629/ZERODHA/636423235028712,Dr.,INR,5000,247356
178,28-03-2024,28-03-2024,BIL/BPAY/0000000R8E35/BBPS/Vi  Postpai/727609,Dr.,INR,473,246882
179,28-03-2024,28-03-2024,VPS/HP  AUTO  CAR/202403281851/408813195472/NASIK,Dr.,INR,2510,244372
180,29-03-2024,30-03-2024,000501534170:Int.Pd:30-12-2023  to  29-03-2024,Cr.,INR,1073,245445
181,30-03-2024,30-03-2024,NEFT-N090242960932488-TATA  MOTORS  LIMITED-TML  SALARY/PEN/OTH-00070310001852-HDF,Cr.,INR,153101,398546
182,30-03-2024,30-03-2024,BIL/NEFT/HS92409038238608/RUPALI  MUL/SBIN0016846,Dr.,INR,46000,352546
183,30-03-2024,30-03-2024,BIL/NEFT/HS92409038238721/MANAS/SBIN0016846,Dr.,INR,2000,350546
184,30-03-2024,30-03-2024,BIL/NEFT/HS92409038237186/PRAMOD/SBIN0000575,Dr.,INR,6000,344546
185,04-04-2024,04-04-2024,NEFT-YESB40952424454-ZERODHA  BROKING  LTD-DSCNB  A/C-YESB0000001-002283000000071-,Cr.,INR,6915,351462
186,05-04-2024,05-04-2024,BIL/NEFT/HS92409639267872/SWARGANGA  /HDFC0CPDCCB,Dr.,INR,28500,322962
187,06-04-2024,06-04-2024,BIL/NEFT/HS92409739508881/Family/MANAS          /SBIN00,Dr.,INR,1000,321962
188,07-04-2024,08-04-2024,BIL/NEFT/HS92409839547366/MANASI  MUL/SBIN0016846,Dr.,INR,120000,201962
189,07-04-2024,08-04-2024,BIL/NEFT/HS92409839561720/Family/RUPALI  MUL/SBIN00,Dr.,INR,3500,198462
190,07-04-2024,08-04-2024,ATM/SACWK849/CASH  WDL/07-04-24,Dr.,INR,2000,196462
191,08-04-2024,08-04-2024,BIL/NEFT/HS92409939653736/MANASI  MUL/SBIN0016846,Dr.,INR,10000,186462
192,08-04-2024,08-04-2024,BIL/ONL/000823647032/Pimpri  Chi/PCMCPTAX_YICI22/Pr,Dr.,INR,7457,179005
193,10-04-2024,10-04-2024,BIL/ONL/000824644165/ZERODHA/334360015698640/MUtua,Dr.,INR,8000,171005
194,10-04-2024,10-04-2024,ACH/NJINDIAINVESTPVT/ICIC6000000005555523/40551326,Dr.,INR,2000,169005
195,10-04-2024,10-04-2024,ACH/NJINDIAINVESTPVT/ICIC6000000005555523/40551327,Dr.,INR,2000,167005
196,10-04-2024,10-04-2024,ACH/NJINDIAINVESTPVT/ICIC6000000005555523/40551328,Dr.,INR,2000,165005
197,10-04-2024,10-04-2024,ACH/NJINDIAINVESTPVT/ICIC6000000005555523/40551324,Dr.,INR,2000,163005
198,10-04-2024,10-04-2024,ACH/NJINDIAINVESTPVT/ICIC6000000005555523/40551325,Dr.,INR,2000,161005
199,10-04-2024,10-04-2024,BIL/ONL/000824668366/Maha  Elect/MSEBMUM_YICI229/el,Dr.,INR,850,160155
200,10-04-2024,10-04-2024,VPS/HP  AUTO  CAR/202404101809/410112104538/NASIK,Dr.,INR,2130,158024
201,10-04-2024,10-04-2024,To  RD  Ac  no  000525071243,Dr.,INR,50000,108024
202,12-04-2024,12-04-2024,BIL/NEFT/HS92410340198193/Family/MANAS          /SBIN00,Dr.,INR,870,107154
203,12-04-2024,12-04-2024,MMT/IMPS/410320643905/Family  50586097/SBIN0016846,Dr.,INR,870,106284
204,12-04-2024,12-04-2024,BIL/BIL/0000000RN2G9/IC3141030000000RN2G9/BB,Dr.,INR,1012,105272
205,13-04-2024,13-04-2024,BIL/ONL/000826115658/State  Bank/MOPSAMSND_YICI2,Dr.,INR,4017,101254
206,14-04-2024,15-04-2024,ATM/SACWK849/CASH  WDL/14-04-24,Dr.,INR,2500,98754
207,15-04-2024,15-04-2024,VPS/PANCHJANYA  /202404151738/410612340117/PUNE,Dr.,INR,10325,88429
208,17-04-2024,17-04-2024,ATM/SACWK849/CASH  WDL/17-04-24,Dr.,INR,1500,86929
209,17-04-2024,17-04-2024,VPS/HINDUSTAN  P/202404171819/410812118405/NASIK,Dr.,INR,1660,85269
210,19-04-2024,19-04-2024,NEFT-IBN52985367421-TATA  MOTORS  KARMACHARI  SAHAKARI  PAT--0061001016278-COSB0000,Cr.,INR,16244,101513
211,20-04-2024,20-04-2024,BIL/BPAY/0000000RUMII/BBPS/Vi  Postpai/955258,Dr.,INR,941,100571
212,20-04-2024,20-04-2024,ATM/SACWK850/CASH  WDL/20-04-24,Dr.,INR,5000,95571
213,22-04-2024,22-04-2024,CMS/001429451235/KOTAKMFV_168__4554835,Dr.,INR,2000,93571
214,22-04-2024,22-04-2024,NEFT-AXISCN0594110394-THE  NEW  INDIA  ASSURANCE  COMPANY  LIM-/CUST/  THE  NEW  INDIA,Cr.,INR,196724,290295
215,23-04-2024,23-04-2024,BIL/NEFT/HS92411441025383/Family/RUPALI  MUL/SBIN00,Dr.,INR,4500,285795
216,25-04-2024,25-04-2024,CLG/MR  PRAMOD  PRABHAKAR  PPF/SBI,Dr.,INR,150000,135795
217,27-04-2024,27-04-2024,BIL/BPAY/0000000S171C/BBPS/Vi  Postpai/727609,Dr.,INR,473,135322
218,29-04-2024,29-04-2024,NEFT-N120243007418139-TATA  MOTORS  LIMITED-TML  SALARY/PEN/OTH-00070310001852-HDF,Cr.,INR,159824,295146
219,29-04-2024,29-04-2024,BIL/NEFT/HS92412041541383/PRAMOD/SBIN0016846,Dr.,INR,46000,249146
220,29-04-2024,29-04-2024,BIL/NEFT/HS92412041540307/MANASI  MUL/SBIN0016846,Dr.,INR,5000,244146
221,29-04-2024,29-04-2024,BIL/NEFT/HS92412041546399/Family/MANAS          /SBIN00,Dr.,INR,2000,242146
222,30-04-2024,30-04-2024,VPS/HINDUSTAN  P/202404301759/412112431712/NASIK,Dr.,INR,1826,240320
223,01-05-2024,01-05-2024,ATM/SACWK849/CASH  WDL/01-05-24,Dr.,INR,7000,233320
224,04-05-2024,04-05-2024,ACH/TATA  MOTORS  LTD/TATAMOTORS  1  7616,Cr.,INR,1500,234820
225,07-05-2024,07-05-2024,VPS/AMANTRAN  PU/202405072121/412815275136/PUNE,Dr.,INR,875,233945
226,10-05-2024,10-05-2024,ACH/NJINDIAINVESTPVT/ICIC6000000005555523/40551326,Dr.,INR,2000,231945
227,10-05-2024,10-05-2024,ACH/NJINDIAINVESTPVT/ICIC6000000005555523/40551327,Dr.,INR,2000,229945
228,10-05-2024,10-05-2024,ACH/NJINDIAINVESTPVT/ICIC6000000005555523/40551328,Dr.,INR,2000,227945
229,10-05-2024,10-05-2024,ACH/NJINDIAINVESTPVT/ICIC6000000005555523/40551324,Dr.,INR,2000,225945
230,10-05-2024,10-05-2024,ACH/NJINDIAINVESTPVT/ICIC6000000005555523/40551325,Dr.,INR,2000,223945
231,10-05-2024,10-05-2024,BIL/ONL/000839335328/BSE  LIMITE/O8LD44TK3KBLEJ/Sip,Dr.,INR,2000,221945
232,10-05-2024,10-05-2024,To  RD  Ac  no  000525071243,Dr.,INR,50000,171945
233,12-05-2024,13-05-2024,VPS/HP  AUTO  CAR/202405120835/413303948611/NASIK,Dr.,INR,1381,170563
234,13-05-2024,13-05-2024,BIL/ONL/000840337653/Maha  Elect/MSEBMUM_YICI232,Dr.,INR,1340,169223
235,13-05-2024,13-05-2024,BIL/ONL/000840356072/ZERODHA/571757650764888/Mf,Dr.,INR,25000,144223
236,15-05-2024,15-05-2024,BIL/NEFT/HS92413643795732/Family/RUPALI  MUL/SBIN00,Dr.,INR,1000,143223
237,16-05-2024,16-05-2024,VPS/HP  AUTO  CAR/202405161825/413712550066/NASIK,Dr.,INR,2380,140842
238,19-05-2024,20-05-2024,VPS/AMANTRAN  PU/202405191511/414009812310/PUNE,Dr.,INR,305,140537
239,20-05-2024,20-05-2024,BIL/BPAY/0000000SO4KK/BBPS/Vi  Postpai/955258,Dr.,INR,941,139596
240,20-05-2024,20-05-2024,BIL/NEFT/HS92414144201402/Bill  Payment/RUPALI  MUL/,Dr.,INR,1000,138596
241,21-05-2024,21-05-2024,CMS/001447590274/KOTAKMFV_168__4554835,Dr.,INR,2000,136596
242,21-05-2024,21-05-2024,VPS/MSW  SHIVALA/202405211833/414213952566/Mumbai,Dr.,INR,803,135793
243,21-05-2024,21-05-2024,VPS/Bharat  Petr/202405211858/414213274874/Mumbai,Dr.,INR,2028,133764
244,22-05-2024,22-05-2024,BIL/NEFT/HS92414344354386/Bill  Payment/RUPALI  MUL/,Dr.,INR,1500,132264
245,22-05-2024,22-05-2024,BIL/NEFT/HS92414344356480/Bill  Payment/RUPALI  MUL/,Dr.,INR,5000,127264
246,23-05-2024,23-05-2024,VPS/SHRI  SAI  PE/202405231038/414405356750/ISLAMPUR,Dr.,INR,534,126729
247,23-05-2024,23-05-2024,VPS/VEERABHADRE/202405232351/414418125821/Haveri,Dr.,INR,2066,124663
248,24-05-2024,24-05-2024,IPS/SHRI  HANAMA/202405241206/000000005790/DHARWAD,Dr.,INR,1613,123050
249,25-05-2024,25-05-2024,VPS/YASHOMALA  E/202405251200/414606571005/KOLHAPUR,Dr.,INR,1900,121150
250,26-05-2024,27-05-2024,BIL/ONL/000845712103/BSE  LIMITE/OF2KBFMMY452HQ/MF,Dr.,INR,2000,119150
251,26-05-2024,27-05-2024,BIL/NEFT/HS92414744642751/Family/RUPALI  MUL/SBIN00,Dr.,INR,3000,116150
252,28-05-2024,28-05-2024,BIL/BPAY/0000000SVYER/BBPS/Vi  Postpai/727609,Dr.,INR,473,115677
253,29-05-2024,29-05-2024,RTGS-HDFCR52024052961365095-TATAMOTORSLIMITED-0007,Cr.,INR,544342,660019
254,29-05-2024,29-05-2024,BIL/NEFT/HS92415044892950/MANASI  MUL/SBIN0016846,Dr.,INR,3000,657019
255,29-05-2024,29-05-2024,BIL/NEFT/HS92415044892253/PRAMOD/SBIN0016846,Dr.,INR,46000,611019
256,29-05-2024,29-05-2024,BIL/NEFT/HS92415044893157/MANAS/SBIN0016846,Dr.,INR,3000,608019
257,31-05-2024,31-05-2024,VPS/HINDUSTAN  P/202405311815/415212100070/NASIK,Dr.,INR,1919,606100
258,07-06-2024,07-06-2024,BIL/BPAY/0000000T5AGR/BBPS/Maharashtr/500411,Dr.,INR,948,605152
259,07-06-2024,07-06-2024,VPS/HP  AUTO  CAR/202406071821/415912246112/NASIK,Dr.,INR,909,604243
260,07-06-2024,07-06-2024,BIL/ONL/000852655948/BSE  LIMITE/OJTMKXNKB5GYSG/Axi,Dr.,INR,1000,603243
261,09-06-2024,10-06-2024,NFS/CASH  WDL/416106010816/MN000247/PUNE          /09-06,Dr.,INR,4000,599243
262,09-06-2024,10-06-2024,TRF  TO  FD  no.  000513275679,Dr.,INR,450000,149243
263,10-06-2024,10-06-2024,ACH/NJINDIAINVESTPVT/ICIC6000000005555523/40551325,Dr.,INR,2000,147243
264,10-06-2024,10-06-2024,ACH/NJINDIAINVESTPVT/ICIC6000000005555523/40551326,Dr.,INR,2000,145243
265,10-06-2024,10-06-2024,ACH/NJINDIAINVESTPVT/ICIC6000000005555523/40551327,Dr.,INR,2000,143243
266,10-06-2024,10-06-2024,ACH/NJINDIAINVESTPVT/ICIC6000000005555523/40551328,Dr.,INR,2000,141243
267,10-06-2024,10-06-2024,ACH/NJINDIAINVESTPVT/ICIC6000000005555523/40551324,Dr.,INR,2000,139243
268,10-06-2024,10-06-2024,To  RD  Ac  no  000525071243,Dr.,INR,50000,89243
269,11-06-2024,11-06-2024,BIL/ONL/000854337571/Maha  Elect/MSEBMUM_YICI235,Dr.,INR,1400,87843
270,12-06-2024,12-06-2024,BIL/NEFT/HS92416446882311/Family/MANAS          /SBIN00,Dr.,INR,1300,86543
271,17-06-2024,17-06-2024,VPS/HINDUSTAN  P/202406171907/416913111656/NASIK,Dr.,INR,2062,84480
272,20-06-2024,20-06-2024,BIL/BPAY/0000000TJ61I/BBPS/Vi  Postpai/955258,Dr.,INR,941,83539
273,21-06-2024,21-06-2024,CMS/001467833492/KOTAKMFV_168__4554835,Dr.,INR,2000,81539
274,24-06-2024,24-06-2024,ATM/SACWK850/CASH  WDL/24-06-24,Dr.,INR,3000,78539
275,25-06-2024,25-06-2024,ACH/TATAMOTORSLTDDIV/00000000000003205110,Cr.,INR,78,78617
276,25-06-2024,25-06-2024,VPS/HINDUSTAN  P/202406251825/417712828726/NASIK,Dr.,INR,1132,77484
277,25-06-2024,25-06-2024,BIL/NEFT/HS92417747980590/Family/RUPALI  MUL/SBIN00,Dr.,INR,3500,73984
278,26-06-2024,26-06-2024,BIL/ONL/000860544815/BSE  LIMITE/ORNLM1XFNNRPUQ/SIP,Dr.,INR,2000,71984
279,27-06-2024,27-06-2024,BIL/BPAY/0000000TPP1A/BBPS/Vi  Postpai/727609,Dr.,INR,473,71511
280,28-06-2024,28-06-2024,VPS/HINDUSTAN  P/202406280641/418001562488/NASIK,Dr.,INR,956,70554
281,28-06-2024,28-06-2024,ATM/SACWK850/CASH  WDL/28-06-24,Dr.,INR,5000,65554
282,28-06-2024,28-06-2024,NEFT-N180243116282537-TATA  MOTORS  LIMITED-TML  SALARY/PEN/OTH-00070310001852-HDF,Cr.,INR,171950,237504
283,29-06-2024,29-06-2024,ATM/S1CND971/CASH  WDL/29-06-24,Dr.,INR,1700,235804
284,29-06-2024,29-06-2024,BIL/NEFT/HS92418148353108/Family/MANAS          /SBIN00,Dr.,INR,2000,233804
285,29-06-2024,29-06-2024,MMT/IMPS/418110733912/Family  50586097/MANASI  PRA/S,Dr.,INR,3000,230804
286,29-06-2024,29-06-2024,BIL/NEFT/HS92418148368719/Family/RUPALI  MUL/SBIN00,Dr.,INR,46000,184804
287,29-06-2024,30-06-2024,000501534170:Int.Pd:30-03-2024  to  29-06-2024,Cr.,INR,1626,186430
288,01-07-2024,01-07-2024,ATM/SACWK850/CASH  WDL/01-07-24,Dr.,INR,15000,171430
289,01-07-2024,01-07-2024,ATM/SACWK850/CASH  WDL  RVSL/01-07-24,Cr.,INR,15000,186430
290,01-07-2024,01-07-2024,NFS/CASH  WDL/418317029425/00575204/PUNE          /01-07,Dr.,INR,10000,176430
291,01-07-2024,01-07-2024,NFS/CASH  WDL/418317029469/00575204/PUNE          /01-07,Dr.,INR,5000,171430
292,02-07-2024,02-07-2024,VPS/HINDUSTAN  P/202407021810/418412255607/NASIK,Dr.,INR,2090,169339
293,03-07-2024,03-07-2024,BIL/NEFT/HS92418549190772/Family/RUPALI  MUL/SBIN00,Dr.,INR,2000,167339
294,03-07-2024,03-07-2024,BIL/NEFT/HS92418549196510/Family/RUPALI  MUL/SBIN00,Dr.,INR,1500,165839
295,04-07-2024,04-07-2024,NEFT-YESEB41862031635-ZERODHA  BROKING  LTD-  FOR  ZERODHA  BR-70B1363FCB75C3ED910B5,Cr.,INR,13034,178873
296,05-07-2024,05-07-2024,BIL/NEFT/HS92418749421080/Family/RUPALI  MUL/SBIN00,Dr.,INR,13000,165873
297,05-07-2024,05-07-2024,BIL/ONL/000866052831/QUEST  2  TR/2867001524,Dr.,INR,14022,151851
298,05-07-2024,05-07-2024,BIL/ONL/000866102922/QUEST  2  TR/2867311184,Dr.,INR,13857,137994
299,10-07-2024,10-07-2024,ACH/NJINDIAINVESTPVT/ICIC6000000005555523/40551328,Dr.,INR,2000,135994
300,10-07-2024,10-07-2024,ACH/NJINDIAINVESTPVT/ICIC6000000005555523/40551324,Dr.,INR,2000,133994
301,10-07-2024,10-07-2024,ACH/NJINDIAINVESTPVT/ICIC6000000005555523/40551325,Dr.,INR,2000,131994
302,10-07-2024,10-07-2024,ACH/NJINDIAINVESTPVT/ICIC6000000005555523/40551326,Dr.,INR,2000,129994
303,10-07-2024,10-07-2024,ACH/NJINDIAINVESTPVT/ICIC6000000005555523/40551327,Dr.,INR,2000,127994
304,10-07-2024,10-07-2024,BIL/ONL/000868346114/Maha  Elect/MSEBMUM_YICI237,Dr.,INR,980,127014
305,10-07-2024,10-07-2024,To  RD  Ac  no  000525071243,Dr.,INR,50000,77014
306,14-07-2024,14-07-2024,BIL/ONL/000870187502/YOUNG  WOME/wwwywcaofdelhio/Ma,Dr.,INR,13428,63586
307,14-07-2024,14-07-2024,VPS/HP  AUTO  CAR/202407141840/419613981312/NASIK,Dr.,INR,2023,61562
308,16-07-2024,16-07-2024,000513275679:  Closure  Proceeds,Cr.,INR,451368,512930
309,16-07-2024,16-07-2024,BIL/ONL/000871249221/State  Bank/SBCOLLECT_YICI2/Co,Dr.,INR,126779,386150
310,18-07-2024,18-07-2024,BIL/NEFT/HS92420050811634/Family/RUPALI  MUL/SBIN00,Dr.,INR,1756,384394
311,21-07-2024,21-07-2024,BIL/NEFT/HS92420351088905/Family/RUPALI  MUL/SBIN00,Dr.,INR,2000,382394
312,22-07-2024,22-07-2024,CLG/SIDDHIDEEP  INSTITUTE  OF  O/UTI,Dr.,INR,28400,353994
313,22-07-2024,22-07-2024,BIL/BPAY/0000000UGC06/BBPS/Vi  Postpai/955258,Dr.,INR,941,353053
314,22-07-2024,22-07-2024,TRF  TO  FD  no.  000513279343,Dr.,INR,10000,343053
315,22-07-2024,22-07-2024,000513279343:  Closure  Proceeds,Cr.,INR,10000,353053
316,22-07-2024,22-07-2024,TRF  TO  FD  no.  000513279346,Dr.,INR,300000,53053
317,22-07-2024,22-07-2024,CMS/001489318419/KOTAKMFV_168__4554835,Dr.,INR,2000,51053
318,22-07-2024,22-07-2024,MMT/IMPS/420420637703/Family  50586097/RUPALI  MUL/S,Dr.,INR,5000,46053
319,23-07-2024,23-07-2024,ATM/SACWK849/CASH  WDL/23-07-24,Dr.,INR,5000,41053
320,25-07-2024,25-07-2024,VPS/HP  AUTO  CAR/202407251807/420712540886/NASIK,Dr.,INR,2303,38749
321,25-07-2024,25-07-2024,ATM/SACWK849/CASH  WDL/25-07-24,Dr.,INR,8000,30749
322,29-07-2024,29-07-2024,NEFT-N211243172056999-TATA  MOTORS  LIMITED-TML  SALARY/PEN/OTH-00070310001852-HDF,Cr.,INR,172249,202998
323,29-07-2024,29-07-2024,BIL/BPAY/0000000UN3IE/BBPS/Vi  Postpai/727609,Dr.,INR,473,202525
324,29-07-2024,29-07-2024,BIL/NEFT/HS92421151744312/RUPALI  MUL/SBIN0016846,Dr.,INR,46000,156525
325,29-07-2024,29-07-2024,BIL/NEFT/HS92421151746483/MANAS/SBIN0016846,Dr.,INR,2000,154525
326,29-07-2024,29-07-2024,BIL/NEFT/HS92421151744993/MANASI  MUL/SBIN0016846,Dr.,INR,3000,151525
327,31-07-2024,31-07-2024,BIL/NEFT/HS92421352072078/Family/RUPALI  MUL/SBIN00,Dr.,INR,4400,147125
328,01-08-2024,01-08-2024,ATM/SACWK849/CASH  WDL/01-08-24,Dr.,INR,12000,135125
329,02-08-2024,02-08-2024,VPS/HP  AUTO  CAR/202408021835/421513201247/NASIK,Dr.,INR,1782,133342
330,06-08-2024,06-08-2024,BIL/ONL/000881361098/NPS  Trust/XBCMFNPSK_ZICI2/NPS,Dr.,INR,50000,83342
331,07-08-2024,07-08-2024,BIL/ONL/000881742220/Maharashtr/MNGL_ZICI224406/mn,Dr.,INR,898,82444
332,07-08-2024,07-08-2024,ATM/SACWK849/CASH  WDL/07-08-24,Dr.,INR,5000,77444
333,07-08-2024,07-08-2024,BIL/NEFT/HS92422053315096/Family/RUPALI  MUL/SBIN00,Dr.,INR,4070,73374
334,08-08-2024,08-08-2024,VPS/PANCHJANYA  /202408081539/422110261115/PUNE,Dr.,INR,4720,68654
335,08-08-2024,08-08-2024,VPS/HINDUSTAN  P/202408081839/422113330847/NASIK,Dr.,INR,1872,66782
336,09-08-2024,09-08-2024,VPS/MSW  SAVITA  /202408100143/422220592724/Pune,Dr.,INR,1999,64783
337,09-08-2024,09-08-2024,VPS/MSW  SAVITA  /202408100144/422220592779/Pune,Dr.,INR,1998,62785
338,09-08-2024,09-08-2024,VPS/MSW  SAVITA  /202408100144/422220592850/Pune,Dr.,INR,1983,60802
339,10-08-2024,10-08-2024,BIL/ONL/000883268516/Maha  Elect/MSEBMUM_YICI240/li,Dr.,INR,960,59842
340,12-08-2024,12-08-2024,ACH/NJINDIAINVESTPVT/ICIC6000000005555523/40551327,Dr.,INR,2000,57842
341,12-08-2024,12-08-2024,ACH/NJINDIAINVESTPVT/ICIC6000000005555523/40551328,Dr.,INR,2000,55842
342,12-08-2024,12-08-2024,ACH/NJINDIAINVESTPVT/ICIC6000000005555523/40551326,Dr.,INR,2000,53842
343,12-08-2024,12-08-2024,ACH/NJINDIAINVESTPVT/ICIC6000000005555523/40551324,Dr.,INR,2000,51842
344,12-08-2024,12-08-2024,ACH/NJINDIAINVESTPVT/ICIC6000000005555523/40551325,Dr.,INR,2000,49842
345,12-08-2024,12-08-2024,VPS/HP  AUTO  CAR/202408121404/422508759241/NASIK,Dr.,INR,1649,48192
346,12-08-2024,12-08-2024,ACH/UTKARSH  SMALL  FINANC/223139,Cr.,INR,50,48242
347,12-08-2024,12-08-2024,VPS/ATO  VARUNAV/202408130124/422519703882/PUNE,Dr.,INR,1440,46802
348,13-08-2024,13-08-2024,VPS/HOTEL  J  C  G/202408132051/422615368780/PUNE,Dr.,INR,1265,45537
349,18-08-2024,18-08-2024,ATM/SACWK849/CASH  WDL/18-08-24,Dr.,INR,5000,40537
350,20-08-2024,20-08-2024,BIL/BPAY/0000000VA31Z/BBPS/Vi  Postpai/955258,Dr.,INR,941,39595
351,21-08-2024,21-08-2024,000525071243  RD  clos  21-08-2024  PRAMOD  PRABHAKAR,Cr.,INR,622102,661697
352,21-08-2024,21-08-2024,CMS/001510623258/KOTAKMFV_168__4554835,Dr.,INR,2000,659697
353,21-08-2024,21-08-2024,VPS/HP  AUTO  CAR/202408211937/423414072254/NASIK,Dr.,INR,1667,658030
354,22-08-2024,22-08-2024,TRF  TO  FD  no.  000513282274,Dr.,INR,600000,58030
355,26-08-2024,26-08-2024,NFS/CASH  WDL/423908007073/00575222/PUNE          /26-08,Dr.,INR,5000,53030
356,27-08-2024,27-08-2024,BIL/NEFT/HS92424055096912/Family/RUPALI  MUL/SBIN00,Dr.,INR,5000,48030
357,29-08-2024,29-08-2024,NEFT-N242243231401568-TATA  MOTORS  LIMITED-TML  SALARY/PEN/OTH-00070310001852-HDF,Cr.,INR,172249,220279
358,29-08-2024,29-08-2024,BIL/NEFT/HS92424255257735/MANASI  MUL/SBIN0016846,Dr.,INR,3000,217279
359,29-08-2024,29-08-2024,BIL/NEFT/HS92424255258472/MANAS/SBIN0016846,Dr.,INR,2000,215279
360,29-08-2024,29-08-2024,BIL/NEFT/HS92424255258515/RUPALI  MUL/SBIN0016846,Dr.,INR,46000,169279
361,29-08-2024,29-08-2024,BIL/BPAY/0000000VJKKT/BBPS/Vi  Postpai/727609,Dr.,INR,473,168805
362,29-08-2024,29-08-2024,Dr  Tran  For  Funding  A/c  000525076345,Dr.,INR,50000,118805
363,30-08-2024,30-08-2024,VPS/HINDUSTAN  P/202408301810/424312765233/NASIK,Dr.,INR,2380,116425
